000100000000000000000000000
000100000000000000000000000
002100000000000000000000000
000100000000000000000000000
000120000000000000000000000
000100000000000000000000000
002100000000000000000000000
000100000000000000000000000
000120000000000000000000000
000100000000000000000000000
002112000000000000000000000
000111200000000000000000000
000011120000000000000000000
000002112000000202000000000
000000211120021111120000000
0000000021111111111112000000
000000000002002002021112000
000000000000000000000211100
000000000000000000000001111
000000000000000000000000111
