000000000000000000000000110
000000000000000000000000110
000000000000000000000002110
000000000000000000000000110
000000000000000000000002110
000000000000000000000011110
000000000000000000200211110
000000000000000000111112020
000000000000000002111000000
000000000000000000112000000
000000000000000000110000000
000000000000000002110000000
000000000000000211110000000
000000000000000111120000000
000000000000000112000000000
000000000000000110000000000
000000000000002110000000000
000000000000000112000000000
002020020202002110000000000
111111111111111110000000000