000000000000000000000000000
111111200000000000000000000
111111100000000000000000000
020021112000000000000000000
000002111200000000000000000
000000111111202000000000000
000000211111111000000000000
000000000000011120000000000
000000000000011100000000000
000000000000001112000000000
000000000000021111120000000
000000000000000211110000000
000000000000000001111200000
000000000000000002111100000
000000000000000000001120000
000000000000000000001100000
000000000000000000021100000
000000000000000000001120000
000000000000000000021100000
000000000000000000002111111
