000000000000001111111111110
000000000011111111111111110
000000000211202002002020000
000000002110000000000000000
000000000110000000000000000
000000000110000000000000000
000000000110000000000000000
000000000110000000000000000
000000000112000000000000000
000000000110000000000000000
000000002112000000000000000
000000000110000000000000000
000000000012000000000000000
000000000010000000000000000
000000000012000000000000000
000200200210000000000000000
111111111112000000000000000
111111111110000000000000000
002020202000000000000000000
000000000000000000000000000
