000100000000000000000000000
000120000000000000000000000
000100000000000000000000000
000120000000000000000000000
000100000000000000000000000
000120000000000000000000000
000100000000000000000000000
000100000000000000000000000
000120000000000000000000000
000112000000000000000000000
000111200020020000000000000
000211111111110000000000000
000002002001112000000000000
000000000002112000000000000
000000000000110000000000000
000000000000110000000000000
000000000000110000000000000
000000000000110000000000000
000000000000110000000000000
000000000000110000000000000