000000000000000000000000000
110000000000000000000000000
112000000000000000000000000
011200000000000000000000000
001100000000000000000000000
002100000000000000000000000
000120000000000000000000000
000100000000000000000000000
002100000000000000000000000
000120000000000000000000000
002100000000000000000000000
000100000000000000000000000
002100000000000000000000000
000110000000000000000000000
000210000000000000000000000
000012000000000000000000000
000011020020020202000000000
000021111111111111120000000
000000200200200000111000000
000000000000000000111000000
