000000000000000000000000110
000000000000000000000000110
000000000000000000000000110
000000000000000000000002110
000000000000000000000021110
000000000000000000000111000
000000000000000000002110000
000000000000000000001120000
000000000000000000211200000
000000000000000000011000000
000000000000000000211000000
0000000000000000001112 00000
000000000000000002110000000
000000000000000000112000000
000000000000000002100000000
000000000000000011100000000
000000000000002111200000000
000002020002001102000000000
111111111111111200000000000
002020000200020000000000000
