000000000000000000000000011
000000000000000000000000211
000000000000000000000000110
000000000000000000000002110
000000000000000000000000110
000000000000000000000002110
000000000000000000000000110
000000000000000000000021100
000000000000000000000001100
000000000000000000000001120
000000000000000000000021100
000000000000000000000011200
000000002000200020020211000
000000011111111111111112000
000000211111111111111110000
000000011200020020002000000
000000211000000000000000000
000000011000000000000000000
000000011200000000000000000
000000011000000000000000000